{
	"width": 8,
	"height": 5,
	"data": [
		"Wa", "  ", "  ", "  ", "  ", "  ", "  ", "Wa",
		"  ", "Wa", "  ", "Bo", "  ", "  ", "  ", "  ",
		"  ", "Wa", "  ", "  ", "Pl", "  ", "  ", "  ",
		"  ", "Wa", "  ", "  ", "  ", "  ", "  ", "  ",
		"Wa", "  ", "  ", "  ", "  ", "  ", "  ", "Wa"
	],
	"floor": [
		"  ", "  ", "  ", "  ", "  ", "  ", "  ", "  ",
		"  ", "  ", "  ", "  ", "  ", "  ", "  ", "  ",
		"  ", "  ", "  ", "  ", "  ", "  ", "  ", "  ",
		"  ", "  ", "  ", "  ", "  ", "Ta", "  ", "  ",
		"  ", "  ", "  ", "  ", "  ", "  ", "  ", "  "
	]
}
